19 0
1 0
111111111111111111111
000101010100010000001
110000010001010111101
100011011101010110101
101111010101011100101
100010010101000001101
101111110101101000001
100000000000101011011
101111111110101001011
100000001000101111011
101111100011101000001
100100001001000011101
101111111111111111101
101111111111111111101
101110111111111111101
100000000000000000001
101111111101111111101
100000000000000000001
111111111111110111111
000000000000000000001
111111111111111111111