0 1
9 8
1011111111
1000000001
1011111101
1011110001
1011110101
1011110101
1000010101
1011110101
1000000101
1111111101